# S:시작, 1:길, P:데이터, Q:탈출구, G:가디언
0,0,0,0,0,0,0,0,0,0
0,S,1,P,1,1,1,1,1,0
0,1,0,0,0,0,0,0,1,0
0,1,0,0,0,0,0,0,1,0
0,P,0,0,0,0,0,0,G,0
0,1,0,0,0,0,0,0,1,0
0,1,1,1,1,1,1,1,1,0
0,0,0,0,0,0,0,0,1,0
0,0,0,0,0,0,0,0,Q,0
0,0,0,0,0,0,0,0,0,0
